1111111111111
1000000000001
1210101010101
1010101010101
1010101010101
1010101010001
1010101010109
1000101010101
1010101010101
1010101010101
1010101010131
1000000000001
1111111111111